
              R 800 600


NO ./textures/illusion.xpm        

SO            ./textures/fractal.xpm
WE ./textures/phoenix.xpm
EA ./textures/text.xpm

S ./textures/barrel.xpm



F  77 ,      34  ,    0
C        132,252,255




111111111
122222221
122222221
122222221
122222221
122222221
122222221
122222221
122222221
122222221 11111111111111
100000001 10000000000001    11111111
111100111 10000000000001    10000001
   1001   10000000000001    11111111
   1001   10000000000001
   1001   10000000000001  1111
   100111110000000000001  1001
   100000000000000000001  1001
   111111110000000000001111001
          100000N0000000000001
          10000202000001111111
          10000202000001
          10000000000001
          11111111111111
