
    R       1280 720                  

NO ./textures/colorstone.xpm        

SO            ./textures/greystone.xpm

WE ./textures/redbrick.xpm
EA ./textures/wood.xpm
S ./textures/barrel.xpm




          F  77, 34, 0 
C        132,252,255

11111111111111
10000000000001
10000202000001
10000202000001
10000202000001
100000N0000001
10000000000001
10000000002001
12000000000021
11111111111111


