
    R       1920 1080                    

NO ./path_to_the_north_texture            
SO            ./path_to_the_south_texture


WE ../textures
EA ../textures
S ../textures




          F  1, 1, 1 
C        225,          30,0

1111111111111111111111111111
1000000200000000000000000001
1000000000000000000000000001
1000000000000000000000000001
1000000000000000000000000001
100000000N000000000000111111
10000000000000000000001
1000002222000000000000111111
1000000000000000200000000001
1111111111111111111111111111
