
    R       1920 1080                    

NO ./path_to_the_north_texture            
SO            ./path_to_the_south_texture


WE ../textures
EA ../textures
S ../textures




          F  1, 1, 1 
C        225,          30,0

11111111111111
10000000000001
10000000000001
10000000000001
10000000000001
10000000000001
10000000000001
10000000000001
1000000N000001
11111111111111
