
    R       1920 1080                    

NO ./path_to_the_north_texture            
SO            ./path_to_the_south_texture


WE ../textures
EA ../textures
S ../textures




          F  77, 34, 0 
C        132,252,255

11111111111111
11010101010101
10000000000001
11000001000001
10000000000001
1000100N001001
10000000000001
10000001100001
10010000000001
11111111111111
