
    R       1280 720                  

NO ./textures/t3.xpm        
SO            ./textures/greystone.xpm


WE ./textures/redbrick.xpm
EA ./textures/t4.xpm
S ./textures




          F  77, 34, 0 
C        132,252,255

11111111111111
10000000000001
10000000000001
10000002000001
10000000000001
1000000E000001
10000000000001
10000000000001
10000000000001
11111111111111
