R 800 600

NO ./textures/greystone.xpm
SO ./textures/colorstone.xpm
WE ./textures/redbrick.xpm
EA ./textures/wood.xpm
S  ./textures/barrel.xpm

F  77,34,0
C  132,252,255

111111111111111111111111111111111111111111111111111111111111111111111111111
100000000000000000000000000000000000000000000000000000000000000000000000001
100000000000000000000000000000000000000000000000000000000000000000000000001
100000000000000000000000000000000000000000000000000000000000000000000000001
100000000000000000000000000000000000000000000000000000000000000000000000001
100000000000000000000000000000000000000000000000000000000000000000000000001
100000000000000111111111111111110000000000000000000000000000000000000000001
100000000000000120000000000000000000000000000000000000000000000000000000001
100000000000000111110111111111000000000000000000000000000000000000000000001
10000000000000000100S001000000000000000000000000000000000000000000000000001
100000000000000001000001000000000000000000000000000000000000000000000000001
100000000000000001111001000000000000000000000000000000000000000000000000001
100000000000000001000001000000000000000000000000000000000000000000000000001
100000000000000001001111000000000000000000000000000000000000000000000000001
100000000000000001000001000000000000000000000000000000000000000000000000001
100000000000000001220221000000000000000000000000000000000000000000000000001
111111111111111111111111111111111111111111111111111111111111111111111111111
