
    R       1280 720                  

NO ./textures/colorstone.xpm        
SO            ./textures/greystone.xpm


WE ./textures/redbrick.xpm
EA ./textures/wood.xpm
S ./textures/pillar.xpm




          F  77, 34, 0 
C        132,252,255

11111111111111
10000002000001
10000111110001
10000022200001
10000000000001
1000000N000001
10000000000001
10000000000001
10000000000001
11111111111111


