
              R 1280 720                  


NO ./textures/colorstone.xpm        



SO            ./textures/greystone.xpm
WE ./textures/redbrick.xpm
EA ./textures/wood.xpm

S ./textures/barrel.xpm




          F  77, 34, 0
C        132,252,255


11111111111111
12222222222221
12222222222221
12222222222221
12222222222221
12222222222221  1111
10000202000001  1001
10000202000001  1001
10000111000001111001
100000W0000000000001
10000202000001111111
10000202002001
12000000000021
11111111111111
