1111111111111111111111111111111
1000000000000000000000000000001
1000000000000000000000000000001
1000000000000000000000000000001
1000000000000000000000000000001
10000000000000000000000000000011111111111111111111
10000000000000000000000000000000000000000000000001
10000000000000000000000000000000000000000000000001
10000000000000000000000000000000000000000000000001
10000000000000000000000011111000000000000000000001
100000000000000000000001111100000000000W0000000001
10000000000000000000000011111000000000000000000001
10000000000000000000000000000000000000000000000001
10000000000000000000000000000011111111111111111111
1000000000000000000000000000001
1000000000000000000000000000001
1000000000000000000000000000001
1000000000000000000000000000001
1000000000000000000000000000001
1111111111111111111111111111111
