111111111111111111111111111111111111111111111111111
100000000000000000000000000000000000000000000000001
100001110000000001000000000000000000000000000000001
100001110000000000000000000000000000001100000000001
100001110000000000000000000000000000001100000000001
100000000000000000000001110000000000000000000000001
100000000000000000000001110000000000000000000000001
100000000000000000000001110000000000000000111000001
100000000000000000000000000000000000000000111000001
100000000000000000000000000000000000000000111000001
100000000111000000000000000000000000000000000000001
100000000111000000000000000000000000000000000000001
100000000111000000000000000000000000000000000000001
100000000000000000100000000000000001100000000000001
100000000000000000000000000000000001100000000000001
100000000000000000000000000000000000000000000000001
100000000000000000000000000000000000000000000000001
100000000110000000000000000000000000000000000000001
100000000110000000000000000000000000000000000000001
100000000000000000000000000000000000000000000000001
100000000000000000000000000000000000000111000000001
100000000000000000000111110000000000000101000000001
100000000011100000000111110000000000000111000000001
100000000011100000000111110000000000000000000000001
100000000000000000000111110000000000000000000000001
100000000000000000000000000000000111000000000000001
100000000000000000000000000000000111000000000000001
100000000000000000000000000000000111000000000000001
100000000000000000000000000000000111000000000000001
100000000000000000000000000000000000000000000000001
100000000000000000000000000000000000000000000000001
1000000000000000000000000000000000000000000000000W1
111111111111111111111111111111111111111111111111111
